100000010000000
00000000000X000
101101111111100
001100000011100
100001100100110
000001011111110
000000000000111
000000000001100
110110100000100
000101100000100
010001100011101
000000100111100
I11111111111100
011000010000100
001000000000011
